1  1    1   1   1   1   1    1   1   1  1   1   1   1    1   1   1   1     1
1  0    0   0   1   1   1    0   1   0  1   0   0   0    0   0   1   9     1
1  2    1   1   0   1   1    1   1   0  1   0   8   0    1   0   0   0     1
1  0    0   0   0   0   1    0   0   0  1   0   0   0    1   0   0   0     1
1  0    0   0   0   0   0    0   0   0  1   0   0   0    1   0   0   0     1
1  0    6   0   0   0   18   0   0   0  0   0   0   0    1   0   0   0     1
1  0    0   0   0   0   0    0   0   0  0   0   0   0    1   0   0   0     1
1  0    0   0   0   0   0    0   0   0  1   0   0   0    1   0   0   0     1
1  0    0   0   0   0   0    0   0   0  1   0   0   0    1   0   0   0     1
1  0    0   7   0   0   0    0   0   0  0   1   0   0    0   1   0   0     0
1  0    0   0   0   0   28   0   1   1  0   0   0   0    1   1   1   0     1
1  0    0   0   0   1   1    1   1   1  0   0   0   0    1   1   1   0     1
1  0    0   0   0   1   0    1   1   1  0   0   0   0    1   1   1   0     1
1  0    0   0   0   0   1    0   0   1  0   0   0   0    1   1   1   0     1
1  0    0   48  0   0   0    0   0   1  1   0   0   0    1   1   1   0     1
1  0    0   17  0   0   0    0   0   1  0   0   0   0    1   1   1   0     1
1  16   0   0   0   0   0    0   0   1  0   26  36  0    1   1   1   0     1
1  0    0   0   0   0   0    0   0   1  0   0   0   0    1   1   1   0     1
1  0    0   0   0   0   0    0   0   1  0   0   0   0    0   0   0   0     1
1  0    0   0   0   0   0    0   0   1  0   0   0   0    1   1   1   0     1
1  0    0   0   0   0   0    0   1   1  0   0   0   0    1   1   1   0     1
1  1    1   1   1   1   1    1   1   1  1   1   1   1    1   1   1   1     1
