1  1  1  1  1  1  1  1  1  1
1  0  0  0  1  1  1  0  1  1
1  0  1  1  0  1  1  1  1  1
1  0  2  0  8  0  1  0  0  1
1  0  0  0  0  0  0  0  0  1
1  0  0  0  0  0  0  0  0  1
1  0  0  18  0  0  0  0  0 1
1  0  0  0  0  0  0  0  0  1
1  0  0  7  0  0  0  0  0  1
1  1  1  1  1  1  28  1  1  1
